111111
100E01
101P01
1C0001
111111