1111111111111111111
1E0000000C000000001
1010101001000010101
1101000100000010101
1P00000C00C000000C1
1111111111111111111