1111101
10000E1
1000P01
1111111