1111111
1E00001
1P00000
1111111
